........
........
.xxx....
.x.x....
.xxx....
........
